40
30
########################################
#......................................#
#......................................#
#......................................#
#..1111111111111111111111111111111111..#
#..1111111111111111111111111111111111..#
#......................................#
#......................................#
#......................................#
#..2222222222222222222222222222222222..#
#..2222222222222222222222222222222222..#
#..2222222222222222222222222222222222..#
#......................................#
#......................................#
#......................................#
#......................................#
#......................................#
#......................................#
#......................................#
#......................................#
#......................................#
#......................................#
#......................................#
#......................................#
#......................................#
#......................................#
#......................................#
#......................................#
#......................................#
#$$$$$$$$$$$$$$$$$$$$$$$$$$$$$$$$$$$$$$#

